....................
.........B..........
...........S........
.......######.......
..C..............C..
####.............###
....................
.........F..........
....................
....................
.C.F............S.C.
####............####
.....C.C.C.C.C......
.P..................
####################
